87 87 87 87 87 87 87 87 1 1 1 1 1 1 1 1 1 1 1 1 1 1 1 1 1 1 1 1 1 1 1 1 87 87 87 87 87 87 87 87 87 87 87 87 87 87 87 87 87 87
87 87 87 87 87 87 87 87 1 90 90 90 90 90 90 90 90 90 90 90 90 90 90 90 90 90 90 90 90 90 90 1 87 87 87 87 87 87 87 87 87 87 87 87 87 87 87 87 87 87
87 87 87 87 87 87 87 87 1 90 90 90 90 90 90 90 90 90 90 90 90 90 90 90 90 90 90 90 90 90 90 1 87 87 87 87 87 87 87 87 87 87 87 87 87 87 87 87 87 87
87 87 87 87 87 87 87 87 1 90 90 90 90 90 90 90 90 90 90 90 90 90 90 90 90 90 90 90 90 90 90 1 87 87 87 87 87 87 87 87 87 87 87 87 87 87 87 87 87 87
87 87 87 87 87 87 87 87 1 90 90 90 90 90 90 90 110 90 90 90 90 90 90 90 94 96 90 90 90 90 90 1 87 87 87 87 87 87 87 87 87 87 87 87 87 87 87 87 87 87
87 87 87 87 87 87 87 87 1 90 88 90 90 90 90 90 0 90 90 90 90 90 90 90 95 97 90 90 90 90 90 1 87 87 87 87 87 87 87 87 87 87 87 87 87 87 87 87 87 87
87 87 87 87 87 87 87 87 1 89 89 89 89 89 89 89 89 89 89 89 89 89 89 89 89 89 89 89 89 89 89 1 87 87 87 87 87 87 87 87 87 87 87 87 87 87 87 87 87 87
87 87 87 87 87 87 87 87 1 89 89 89 89 89 89 89 89 89 89 89 89 89 89 89 89 89 89 89 89 89 89 1 87 87 87 87 87 87 87 87 87 87 87 87 87 87 87 87 87 87
87 87 87 87 87 87 87 87 1 89 89 89 89 89 89 89 89 89 89 89 89 89 89 89 89 89 89 89 89 98 99 1 87 87 87 87 87 87 87 87 87 87 87 87 87 87 87 87 87 87
87 87 87 87 87 87 87 87 1 1 1 1 1 1 1 1 1 1 1 1 1 1 1 1 1 1 1 1 1 0 0 1 87 87 87 87 87 87 87 87 87 87 87 87 87 87 87 87 87 87
87 87 87 87 87 87 87 87 87 87 87 87 87 87 87 87 87 87 87 87 87 87 87 87 87 87 87 87 87 87 87 87 87 87 87 87 87 87 87 87 87 87 87 87 87 87 87 87 87 87
87 87 87 87 87 87 87 87 87 87 87 87 87 87 87 87 87 87 87 87 87 87 87 87 87 87 87 87 87 87 87 87 87 87 87 87 87 87 87 87 87 87 87 87 87 87 87 87 87 87
87 87 87 87 87 87 87 87 87 87 87 87 87 87 87 87 87 87 87 87 87 87 87 87 87 87 87 87 87 87 87 87 87 87 87 87 87 87 87 87 87 87 87 87 87 87 87 87 87 87
87 87 87 87 87 87 87 87 87 87 87 87 87 87 87 87 87 87 87 87 87 87 87 87 87 87 87 87 87 87 87 87 87 87 87 87 87 87 87 87 87 87 87 87 87 87 87 87 87 87
87 87 87 87 87 87 87 87 87 87 87 87 87 87 87 87 87 87 87 87 87 87 87 87 87 87 87 87 87 87 87 87 87 87 87 87 87 87 87 87 87 87 87 87 87 87 87 87 87 87
87 87 87 87 87 87 87 87 87 87 87 87 87 87 87 87 87 87 87 87 87 87 87 87 87 87 87 87 87 87 87 87 87 87 87 87 87 87 87 87 87 87 87 87 87 87 87 87 87 87
87 87 87 87 87 87 87 87 1 1 1 1 1 1 1 1 1 1 1 1 1 1 87 87 87 87 87 87 87 87 87 87 87 87 87 87 87 87 87 87 87 87 87 87 87 87 87 87 87 87
87 87 87 87 87 87 87 87 1 90 90 90 90 90 90 90 90 90 90 90 90 1 87 87 87 87 87 87 87 87 87 87 87 87 87 87 87 87 87 87 87 87 87 87 87 87 87 87 87 87
87 87 87 87 87 87 87 87 1 90 90 90 90 90 90 90 90 90 90 90 90 1 87 87 87 87 87 87 87 87 87 87 87 87 87 87 87 87 87 87 87 87 87 87 87 87 87 87 87 87
87 87 87 87 87 87 87 87 1 90 90 90 90 90 90 90 90 90 90 90 90 1 87 87 87 87 87 87 87 87 87 87 87 87 87 87 87 87 87 87 87 87 87 87 87 87 87 87 87 87
87 87 87 87 87 87 87 87 1 90 90 90 90 105 105 105 105 105 90 90 90 1 87 87 87 87 87 87 87 87 87 87 87 87 87 87 87 87 87 87 87 87 87 87 87 87 87 87 87 87
87 87 87 87 87 87 87 87 1 90 90 90 90 106 106 106 106 106 90 90 90 1 87 87 87 87 87 87 87 87 87 87 87 87 87 87 87 87 87 87 87 87 87 87 87 87 87 87 87 87
87 87 87 87 87 87 87 87 1 89 89 89 89 89 89 89 89 89 89 89 89 1 87 87 87 87 87 87 87 87 87 87 87 87 87 87 87 87 87 87 87 87 87 87 87 87 87 87 87 87
87 87 87 87 87 87 87 87 1 89 89 89 89 89 89 89 89 89 89 89 89 1 87 87 87 87 87 87 87 87 87 87 87 87 87 87 87 87 87 87 87 87 87 87 87 87 87 87 87 87
87 87 87 87 87 87 87 87 1 104 1 89 89 89 89 89 89 89 89 89 89 1 87 87 87 87 87 87 87 87 87 87 87 87 87 87 87 87 87 87 87 87 87 87 87 87 87 87 87 87
87 87 87 87 87 87 87 87 1 0 1 1 1 1 1 1 1 1 1 1 1 1 87 87 87 87 87 87 87 87 87 87 87 87 87 87 87 87 87 87 87 87 87 87 87 87 87 87 87 87 87
87 87 87 87 87 87 87 87 87 87 87 87 87 87 87 87 87 87 87 87 87 87 87 87 87 87 87 87 87 87 87 87 87 87 87 87 87 87 87 87 87 87 87 87 87 87 87 87 87 87
87 87 87 87 87 87 87 87 87 87 87 87 87 87 87 87 87 87 87 87 87 87 87 87 87 87 87 87 87 87 87 87 87 87 87 87 87 87 87 87 87 87 87 87 87 87 87 87 87 87
87 87 87 87 87 87 87 87 87 87 87 87 87 87 87 87 87 87 87 87 87 87 87 87 87 87 87 87 87 87 87 87 87 87 87 87 87 87 87 87 87 87 87 87 87 87 87 87 87 87
87 87 87 87 87 87 87 87 87 87 87 87 87 87 87 87 87 87 87 87 87 87 87 87 87 87 87 87 87 87 87 87 87 87 87 87 87 87 87 87 87 87 87 87 87 87 87 87 87 87
87 87 87 87 87 87 87 87 87 87 87 87 87 87 87 87 87 87 87 87 87 87 87 87 87 87 87 87 87 87 87 87 87 87 87 87 87 87 87 87 87 87 87 87 87 87 87 87 87 87
87 87 87 87 87 87 87 87 87 87 87 87 87 87 87 87 87 87 87 87 87 87 87 87 87 87 87 87 87 87 87 87 87 87 87 87 87 87 87 87 87 87 87 87 87 87 87 87 87 87
87 87 87 87 87 87 87 87 1 1 1 1 1 1 1 1 1 1 1 1 1 1 1 1 1 1 1 1 1 1 1 1 87 87 87 87 87 87 87 87 87 87 87 87 87 87 87 87 87 87
87 87 87 87 87 87 87 87 1 89 89 89 89 109 89 89 89 109 89 109 89 89 109 89 89 89 109 89 89 89 89 1 87 87 87 87 87 87 87 87 87 87 87 87 87 87 87 87 87 87
87 87 87 87 87 87 87 87 1 89 109 109 109 109 89 89 89 89 89 89 89 89 109 89 89 89 89 89 109 89 89 1 87 87 87 87 87 87 87 87 87 87 87 87 87 87 87 87 87 87
87 87 87 87 87 87 87 87 1 89 109 89 89 89 89 89 109 109 109 109 89 89 109 89 89 109 89 89 109 109 89 1 87 87 87 87 87 87 87 87 87 87 87 87 87 87 87 87 87 87
87 87 87 87 87 87 87 87 1 89 109 109 109 109 89 109 89 89 89 109 89 89 89 109 109 109 89 109 89 89 89 1 87 87 87 87 87 87 87 87 87 87 87 87 87 87 87 87 87 87
87 87 87 87 87 87 87 87 1 89 89 89 89 89 89 89 109 89 89 89 109 89 89 89 89 89 89 109 89 109 89 1 87 87 87 87 87 87 87 87 87 87 87 87 87 87 87 87 87 87
87 87 87 87 87 87 87 87 1 89 89 89 89 89 89 89 89 89 89 109 109 109 109 89 89 109 89 109 109 109 89 1 87 87 87 87 87 87 87 87 87 87 87 87 87 87 87 87 87 87
87 87 87 87 87 87 87 87 1 89 89 109 89 109 89 89 89 89 89 109 89 89 109 109 109 89 89 89 109 89 89 1 87 87 87 87 87 87 87 87 87 87 87 87 87 87 87 87 87 87
87 87 87 87 87 87 87 87 1 107 89 109 89 109 89 89 89 89 89 109 89 89 89 89 89 89 89 109 89 89 89 1 87 87 87 87 87 87 87 87 87 87 87 87 87 87 87 87 87 87
87 87 87 87 87 87 87 87 1 0 1 1 1 1 1 1 1 1 1 1 1 1 1 1 1 1 1 1 1 1 1 1 87 87 87 87 87 87 87 87 87 87 87 87 87 87 87 87 87 87
87 87 87 87 87 87 87 87 87 87 87 87 87 87 87 87 87 87 87 87 87 87 87 87 87 87 87 87 87 87 87 87 87 87 87 87 87 87 87 87 87 87 87 87 87 87 87 87 87 87
87 87 87 87 87 87 87 87 87 87 87 87 87 87 87 87 87 87 87 87 87 87 87 87 87 87 87 87 87 87 87 87 87 87 87 87 87 87 87 87 87 87 87 87 87 87 87 87 87 87
87 87 87 87 87 87 87 87 87 87 87 87 87 87 87 87 87 87 87 87 87 87 87 87 87 87 87 87 87 87 87 87 87 87 87 87 87 87 87 87 87 87 87 87 87 87 87 87 87 87
87 87 87 87 87 87 87 87 87 87 87 87 87 87 87 87 87 87 87 87 87 87 87 87 87 87 87 87 87 87 87 87 87 87 87 87 87 87 87 87 87 87 87 87 87 87 87 87 87 87
87 87 87 87 87 87 87 87 87 87 87 87 87 87 87 87 87 87 87 87 87 87 87 87 87 87 87 87 87 87 87 87 87 87 87 87 87 87 87 87 87 87 87 87 87 87 87 87 87 87
87 87 87 87 87 87 87 87 87 87 87 87 87 87 87 87 87 87 87 87 87 87 87 87 87 87 87 87 87 87 87 87 87 87 87 87 87 87 87 87 87 87 87 87 87 87 87 87 87 87
87 87 87 87 87 87 87 87 87 87 87 87 87 87 87 87 87 87 87 87 87 87 87 87 87 87 87 87 87 87 87 87 87 87 87 87 87 87 87 87 87 87 87 87 87 87 87 87 87 87
87 87 87 87 87 87 87 87 87 87 87 87 87 87 87 87 87 87 87 87 87 87 87 87 87 87 87 87 87 87 87 87 87 87 87 87 87 87 87 87 87 87 87 87 87 87 87 87 87 87